x_coord, y_coord, z_coord, cost, zone
113300, 117000, 0, 0, 1
122000, 115500, 0, 0, 1
122900, 118800, 0, 0, 1
108599.34407896471, 119124.61097942466, -17.969321532731254, 1964625.3407984052, 1
108985.72692225907, 120233.69069418007, -19.760061534606123, 2094644.883818533, 1
109500.90404665154, 118570.07112204695, -16.203464419411766, 1836412.4597144625, 1
109500.90404665154, 121342.77040893548, -25.83322705070921, 2535596.7831800235, 1
109758.49260884778, 119540.51587245794, -16.438480284087237, 1853476.1625946087, 1
109887.2868899459, 122313.21515934647, -31.50410638271389, 2947340.0504871546, 1
110273.66973324025, 120649.59558721335, -21.412468187382736, 2214620.5126940235, 1
110273.66973324025, 123145.02494541302, -34.35459567154662, 3154304.386085717, 1
110402.46401433837, 118015.53126466925, -17.33479428184168, 1918554.4745039665, 1
110660.05257653461, 121758.67530196876, -28.453670600325744, 2725858.279809611, 1
110660.05257653461, 123976.83473147958, -34.70962922932897, 3180082.165602197, 1
111046.43541982897, 124808.64451754614, -33.26482282839113, 3075179.6851718635, 1
111304.0239820252, 117460.99140729154, -20.36665029471439, 2138687.2312882096, 1
111432.81826312332, 125640.4543036127, -30.937074429453805, 2906169.7882695803, 1
111947.9953875158, 126749.53401836811, -27.622091195371926, 2665480.126585891, 1
112076.78966861391, 118431.43615770253, -18.28543944722064, 1987577.58776857, 1
112205.58394971203, 117045.08651425826, -22.16065640189, 2268943.9151094663, 1
112205.58394971203, 119401.88090811351, -18.340002676670164, 1991539.23834392, 1
112334.37823081015, 127581.34380443467, -25.144865748499527, 2485617.209455006, 1
112463.17251190827, 120510.96062286892, -21.723469985157553, 2237201.2958243405, 1
112720.7610741045, 121620.04033762433, -26.341613784187157, 2572509.015382963, 1
112720.7610741045, 128413.15359050123, -22.54446764077948, 2296811.14420702, 1
112849.55535520262, 122590.48508803532, -29.953918865101226, 2834786.205470859, 1
112978.34963630074, 116490.54665688056, -22.053100948477017, 2261134.6793256914, 1
113107.14391739886, 123699.56480279073, -32.26628158209893, 3002679.000318824, 1
113107.14391739886, 129244.96337656779, -21.249697457405404, 2202802.283410851, 1
113235.93819849698, 124670.00955320171, -32.13096791790747, 2992854.3352283402, 1
113493.52676069322, 125640.4543036127, -30.101854133703874, 2845527.2823441834, 1
113493.52676069322, 130076.77316263434, -22.993273148538094, 2329397.386186646, 1
113622.32104179134, 126610.89905402368, -26.629887925778306, 2593439.6206718152, 1
113879.90960398757, 127581.34380443467, -22.436977206420686, 2289006.6292357044, 1
114008.70388508569, 115797.37183515842, -18.87616622011327, 2030468.2502772762, 1
114137.49816618381, 128690.42351919008, -18.601456990040226, 2010522.5470930547, 1
114266.29244728193, 116906.45154991384, -18.72896922830048, 2019780.7771715214, 1
114395.08672838005, 129660.86826960107, -18.980614776987863, 2038051.9048668472, 1
114523.88100947817, 118015.53126466925, -17.30457191529347, 1916360.1312249468, 1
114781.4695716744, 119263.24594376908, -16.098750729206618, 1828809.5546952132, 1
114910.26385277252, 115242.83197778072, -16.988374872441284, 1893402.1390133952, 1
115039.05813387064, 120372.3256585245, -17.15004288550821, 1905140.3037709405, 1
115296.64669606688, 121481.40537327991, -20.677616122237136, 2161265.402740823, 1
115296.64669606688, 128135.88366181238, -18.467277067199845, 2000780.1991073524, 1
115425.440977165, 122451.85012369089, -25.89635239532142, 2540180.0998261445, 1
115425.440977165, 129106.32841222336, -15.962050017121278, 1818884.1807731178, 1
115683.02953936123, 123560.9298384463, -31.879843178881085, 2974621.0217517475, 1
115811.82382045935, 114688.29212040301, -16.90415742743164, 1887287.3966705583, 1
115811.82382045935, 124531.37458885729, -34.49559050775204, 3164541.5417601494, 1
115940.61810155747, 125501.81933926827, -33.124837071540966, 3065015.7953185462, 1
116198.2066637537, 126472.26408967926, -28.275430485172066, 2712916.871064694, 1
116327.00094485182, 127442.70884009024, -22.068686674709213, 2262266.305915942, 1
116455.79522594994, 128551.78855484565, -16.750825872553406, 1876154.5137981363, 1
116713.38378814618, 114133.75226302531, -15.870652753811887, 1812248.1362349181, 1
116842.1780692443, 115797.37183515842, -20.154305213159294, 2123269.5768897715, 1
116970.97235034242, 116767.81658556941, -20.44483107641782, 2144363.672033038, 1
117228.56091253865, 117876.89630032482, -20.280397794323953, 2132424.7304933616, 1
117357.35519363677, 118847.3410507358, -20.410863976007878, 2141897.4363604137, 1
117614.94375583301, 113579.2124056476, -13.158695444236738, 1615342.1366415191, 1
117614.94375583301, 120233.69069418007, -22.236687090282402, 2274464.2448892985, 1
117743.73803693113, 127858.61373312352, -20.856578139194195, 2174259.226321217, 1
117872.53231802925, 121342.77040893548, -24.33380236260649, 2426728.654620825, 1
118001.32659912737, 122313.21515934647, -26.441880823051573, 2579789.064166976, 1
118258.9151613236, 123422.29487410188, -29.466569677522664, 2799401.437948017, 1
118387.70944242172, 124392.73962451286, -31.242053990572213, 2928313.3172718803, 1
118516.50372351984, 113024.6725482699, -11.291740842755361, 1479788.9106736016, 1
118516.50372351984, 125363.18437492385, -31.00930229757848, 2911414.0081993616, 1
118645.29800461796, 126333.62912533483, -28.487661713022284, 2728326.2589327237, 1
118774.09228571608, 127304.07387574582, -24.849806038210758, 2464193.9270939534, 1
119418.06369120667, 112608.76765523662, -13.396193764877008, 1632586.082208919, 1
119546.85797230479, 113717.84736999203, -13.535654167631215, 1642711.8278875325, 1
119675.6522534029, 114688.29212040301, -17.597418325779547, 1937622.7134125454, 1
119804.44653450102, 115658.736870814, -23.60748043420581, 2373992.888894208, 1
119933.24081559914, 116629.18162122498, -29.131485692691093, 2775072.1290949453, 1
120062.03509669726, 117599.62637163597, -32.64826353341976, 3030413.411065595, 1
120062.03509669726, 126610.89905402368, -32.01263609317145, 2984262.6637624623, 1
120190.82937779538, 112054.22779785891, -19.686431554347962, 2089298.8612939208, 1
120190.82937779538, 118708.70608639138, -34.460217681818705, 3161973.241136738, 1
120577.21222108974, 120095.05572983564, -33.71694760494811, 3108006.9279734255, 1
120706.00650218785, 121065.50048024663, -31.2570657625508, 2929403.2709952206, 1
120963.59506438409, 122174.58019500204, -28.573091439643406, 2734529.0209216126, 1
121092.38934548221, 111499.6879404812, -28.661359113710006, 2740937.836625497, 1
121092.38934548221, 126056.35919664598, -36.91336939713092, 3340088.2464697263, 1
121221.18362658033, 123283.65990975745, -28.87521035290964, 2756464.848009569, 1
121349.97790767845, 124254.10466016844, -32.1955144634712, 2997540.8404434677, 1
121736.3607509728, 125363.18437492385, -36.583882625675926, 3316165.3322494016, 1
121993.94931316904, 110945.1480831035, -35.220386521169374, 3217166.5159879364, 1
122122.74359426716, 112331.49772654776, -28.287632328670124, 2713802.8054348202, 1
122251.53787536528, 113301.94247695875, -23.861536254583548, 2392439.018222046, 1
122380.3321564634, 114272.38722736973, -21.261295816408257, 2203644.400823628, 1
122509.12643756151, 115242.83197778072, -21.368507927921726, 2211428.707719442, 1
122766.71499975775, 116490.54665688056, -24.598058033063854, 2445915.360383454, 1
122895.50928085587, 110390.6082257258, -35.15513438084494, 3212428.7799362564, 1
122895.50928085587, 117599.62637163597, -28.54518416754103, 2732502.7687789844, 1
123024.30356195399, 118570.07112204695, -30.861865418933004, 2900709.117726301, 1
123024.30356195399, 124947.27948189057, -30.682652385383374, 2887697.0686845765, 1
123281.89212415022, 119679.15083680236, -29.64309518561385, 2812218.35490379, 1
123410.68640524834, 120926.8655159022, -23.092899381866353, 2336630.908259418, 1
123539.48068634646, 122035.94523065761, -17.64313356296738, 1940941.9413529476, 1
123797.0692485427, 109836.06836834809, -28.12063328014044, 2701677.5723178447, 1
123797.0692485427, 123145.02494541302, -16.51091495318248, 1858735.397639739, 1
124054.65781073894, 124392.73962451286, -20.709489483006145, 2163579.619096834, 1
124698.62921622953, 109281.52851097038, -19.892094137395304, 2104231.3221962056, 1
124827.42349732765, 110251.97326138137, -18.766607982219284, 2022513.5991218027, 1
124956.21777842577, 111222.41801179235, -18.51452644606256, 2004210.8158586859, 1
125085.01205952388, 112192.86276220334, -18.05520472598311, 1970861.0274575655, 1
125085.01205952388, 123838.19976713516, -13.012469652533616, 1604725.1790736474, 1
125213.806340622, 113163.30751261432, -16.80519706103205, 1880102.2209315298, 1
125342.60062172012, 114133.75226302531, -15.570809449020501, 1790477.5333412522, 1
125471.39490281824, 115104.1970134363, -15.981561737874031, 1820300.8604771246, 1
125600.18918391636, 108865.6236179371, -16.753108860594615, 1876320.273797649, 1
125728.98346501448, 116351.91169253613, -21.00321217768592, 2184905.825300371, 1
125857.7777461126, 117322.35644294712, -27.19788938826343, 2634680.275657888, 1
126115.36630830883, 118570.07112204695, -33.44664071184387, 3088380.8635085635, 1
126115.36630830883, 123283.65990975745, -11.473419741098768, 1492979.9977740617, 1
126244.16058940695, 119540.51587245794, -33.92759804083728, 3123301.5399118564, 1
126372.95487050507, 108311.0837605594, -20.42867479656262, 2143190.6194841038, 1
126501.74915160319, 120649.59558721335, -27.947140147520923, 2689080.8258349923, 1
126759.33771379942, 121758.67530196876, -18.830471144619437, 2027150.4862089257, 1
126888.13199489754, 109142.89354662596, -17.714295579452124, 1946108.7734190484, 1
126888.13199489754, 122729.12005237975, -13.548740317051724, 1643661.9687040476, 1
127145.72055709378, 110113.33829703694, -13.998665138787862, 1676329.4802659147, 1
127403.30911929002, 111083.78304744793, -12.693085893251578, 1581535.81021696, 1
127660.89768148625, 112054.22779785891, -13.465776820056783, 1637638.271263135, 1
127789.69196258437, 113024.6725482699, -14.91665891894713, 1742981.8874644267, 1
128047.28052478061, 113995.11729868088, -17.222001842222454, 1910364.9989575092, 1
128176.07480587873, 114965.56204909187, -19.17710739873587, 2052318.566057056, 1
128176.07480587873, 122174.58019500204, -15.02716260972279, 1751005.1847390987, 1
128304.86908697685, 116074.64176384728, -22.064018430361024, 2261927.360565851, 1
128433.66336807497, 117045.08651425826, -25.57742217831663, 2517023.6611321643, 1
128562.45764917308, 118015.53126466925, -27.815382010284637, 2679514.3154679327, 1
128820.04621136932, 119401.88090811351, -23.84993764536896, 2391596.882642246, 1
128948.84049246744, 120372.3256585245, -18.14190016748532, 1977155.6887005395, 1
129077.63477356556, 121620.04033762433, -13.485436214663617, 1639065.6730635953, 1
129979.19474125239, 121204.13544459105, -11.67684841477734, 1507750.2621123723, 1
130494.37186564486, 115936.00679950285, -31.27580163496874, 2930763.6189895216, 1
130751.9604278411, 120649.59558721335, -12.28460142940109, 1551877.1421439531, 1
130880.75470893922, 116906.45154991384, -30.446326466738135, 2870538.247239869, 1
131009.54899003734, 117876.89630032482, -26.232300479591068, 2564572.148001477, 1
131395.9318333317, 119263.24594376908, -17.952734366648006, 1963421.003065465, 1
131653.52039552794, 120233.69069418007, -15.20797524015631, 1764133.3750719335, 1
131782.31467662606, 118431.43615770253, -23.33018199557865, 2353859.1920801806, 1
132555.08036321477, 119817.78580114679, -19.2797636503663, 2059772.0874566855, 1
